SO./textures/eagle.xpm

EA ./textures/purplestone.xpm
WE ./textures/red.xpm
    NO ./textures/greystone.xpm

F 100,100,0
C 12,0,100

1111111111111
1000000000001
1000000000001
1000000S00001
1111111111111

